NO ./images/wall_no.xpm
SO ./images/wall_so.xpm
WE ./images/wall_we.xpm
EA ./images/wall_ea.xpm

F 98,70,33
C 180,225,231

        1111111111111111111111111
        1000000000110000000000001
        1011000001110000000000001
        1001000000000000000000001
111111111011000001110000000000001
100000000011000001110111110111111
11010111111111011100000010001
11010111111111011101010010001
11000000110101011100000010001
10000000000000000000000010001
11010000000000001101010010001
11011001110101011111011110N111
11110111 1110101 101111010001
11111111 1111111 111111111111
